月	Mon
火	Tue
水	Wed
木	Thu
金	Fri
土	Sat
日	Sun
月曜	Mon
火曜	Tue
水曜	Wed
木曜	Thu
金曜	Fri
土曜	Sat
日曜	Sun
月曜日	Mon
火曜日	Tue
水曜日	Wed
木曜日	Thu
金曜日	Fri
土曜日	Sat
日曜日	Sun
Monday	Mon
Tuesday	Tue
Wednesday	Wed
Thursday	Thu
Friday	Fri
Saturday	Sat
Sunday	Sun
Mon	Mon
Tue	Tue
Wed	Wed
Thu	Thu
Fri	Fri
Sat	Sat
Sun	Sun
Ｍｏｎｄａｙ	Mon
Ｔｕｅｓｄａｙ	Tue
Ｗｅｄｎｅｓｄａｙ	Wed
Ｔｈｕｒｓｄａｙ	Thu
Ｆｒｉｄａｙ	Fri
Ｓａｔｕｒｄａｙ	Sat
Ｓｕｎｄａｙ	Sun
Ｍｏｎ	Mon
Ｔｕｅ	Tue
Ｗｅｄ	Wed
Ｔｈｕ	Thu
Ｆｒｉ	Fri
Ｓａｔ	Sat
Ｓｕｎ	Sun