モル	mol
カンデラ	cd
パスカル	Pa
オーム	Ω
ウェーバ	Wb
ヘルツ	Hz
ステラジアン	sr
ヘクタール	ha
シーシー	cc
メートル	m
グラム	g
ニュートン	N
リットル	l
アンペア	A
ケルビン	K
ジュール	J
ワット	W
クーロン	C
ボルト	V
ファラド	F
ジーメンス	S
テスラ	T
ヘンリー	H
シーベルト	Sv
バイト	バイト
ベクレル	Bq
デシベル	dB
ピクセル	pixel
カロリー	cal
ビット	ビット
マイル	マイル
フィート	フィート
ヤード	ヤード
インチ	インチ
エーカー	エーカー
オンス	オンス
パイント	パイント
ガロン	ガロン
バレル	バレル
オンス	オンス
ポンド	ポンド