ｍｏｌ	mol
ｂｐｓ	bps
m／h	m/h
ｍ／ｓ	m/s
ｍ／ｍ	m/m
ｇ／ｌ	g/l
Ｎ／ｍ２	N/m2
ｃｄ	cd
Ｐａ	Pa
Ｗｂ	Wb
Ｈｚ	Hz
ｓｒ	sr
ｈａ	ha
ｃｃ	cc
ｍ	m
ｇ	g
Ｎ	N
ｌ	l
ｓ	s
Ａ	A
Ｋ	K
Ｊ	J
Ｗ	W
Ｃ	C
Ｖ	V
Ｆ	F
Ｓ	S
Ｔ	T
Ｈ	H
Ｓｖ	Sv
Ｂ	B